#FAMILIES
LACE : ACE;
LACEBCPO : ACEBCPO;
LACEBCPI : ACEBCPI;
LACEOCPO : ACEOCPO;
LACEOCPI : ACEOCPI;
LACY : ACY;
LACYBCPO : ACYBCPO;
LACYBCPI : ACYBCPI;
LACYOCPO : ACYOCPO;
LACYOCPI : ACYOCPI;
LANT : ANT;
LANTBCPO : ANTBCPO;
LANTBCPI : ANTBCPI;
LANTOCPO : ANTOCPO;
LANTOCPI : ANTOCPI;
LBAA : BAA;
LBAABCPO : BAABCPO;
LBAABCPI : BAABCPI;
LBAAOCPO : BAAOCPO;
LBAAOCPI : BAAOCPI;
LBAP : BAP;
LBAPBCPO : BAPBCPO;
LBAPBCPI : BAPBCPI;
LBAPOCPO : BAPOCPO;
LBAPOCPI : BAPOCPI;
LBBF : BBF;
LBBFBCPO : BBFBCPO;
LBBFBCPI : BBFBCPI;
LBBFOCPO : BBFOCPO;
LBBFOCPI : BBFOCPI;
LBHP : BHP;
LBHPBCPO : BHPBCPO;
LBHPBCPI : BHPBCPI;
LBHPOCPO : BHPOCPO;
LBHPOCPI : BHPOCPI;
LBKF : BKF;
LBKFBCPO : BKFBCPO;
LBKFBCPI : BKFBCPI;
LBKFOCPO : BKFOCPO;
LBKFOCPI : BKFOCPI;
LCHR : CHR;
LCHRBCPO : CHRBCPO;
LCHRBCPI : CHRBCPI;
LCHROCPO : CHROCPO;
LCHROCPI : CHROCPI;
LDAHA : DAHA;
LDAHABCPO : DAHABCPO;
LDAHABCPI : DAHABCPI;
LDAHAOCPO : DAHAOCPO;
LDAHAOCPI : DAHAOCPI;
LFLA : FLA;
LFLABCPO : FLABCPO;
LFLABCPI : FLABCPI;
LFLAOCPO : FLAOCPO;
LFLAOCPI : FLAOCPI;
LFLO : FLO;
LFLOBCPO : FLOBCPO;
LFLOBCPI : FLOBCPI;
LFLOOCPO : FLOOCPO;
LFLOOCPI : FLOOCPI;
LICDP : ICDP;
LICDPBCPO : ICDPBCPO;
LICDPBCPI : ICDPBCPI;
LICDPOCPO : ICDPOCPO;
LICDPOCPI : ICDPOCPI;
LNAP : NAP;
LNAPAD : NAPAD;
LNNAP : NNAP;
LPHE : PHE;
LPHEBCPO : PHEBCPO;
LPHEBCPI : PHEBCPI;
LPHEOCPO : PHEOCPO;
LPHEOCPI : PHEOCPI;
LPYR : PYR;
LPYRBCPO : PYRBCPO;
LPYRBCPI : PYRBCPI;
LPYROCPO : PYROCPO;
LPYROCPI : PYROCPI;
